16 15 2 1
4
 4  5  5  5  5  5  5  5  5  5  5  5  5  5  5  6
 8  9  9  9  9  9  9  9  9  9  9  9  9  9  9 10
 8  9  9  9  9  9  9  9  9  9  9  9  9  9  9 10
 8  9  9  9  9  9  9  9  9  9  9  9  9  9  9 10
 8  9  9  9  9  9  9  9  9  9  9  9  9  9  9 10
 8  9  9  9  9  9  9  9  9  9  9  9  9  9  9 10
 8  9  9  9  9  9  9  9  9  9  9  9  9  9  9 10
 8  9  9  9  9  9  9  9  9  9  9  9  9  9  9 10
 8  9  9  9  9  9  9  9  9  9  9  9  9  9  9 10
 8  9  9  9 13 13 13  9  9  9  9  9  9  9  9 10
 8  9  9 10  4  5  6  8  9  9  9  9  9  9  9 10
 9  9  9 10  8  9 10  8  9  9  9  9  9  9  9 10
 9  9  9 10 12 13 14  8  9  9  9  9  9  9  9 10
 9  9  9  9  5  5  5  9  9  9  9  9  9  9  9 10
12 13 13 13 13 13 13 13 13 13 13 13 13 13 13 14
1
-1 -1  -1  -1  -1  -1  -1  -1  -1  -1  -1  -1  -1  -1  -1  -1
-1 -1  -1  -1  -1  -1  -1  -1  -1  -1  -1  -1  -1  -1  -1  -1
-1 -1  -1  -1  -1  -1  -1  -1  -1  -1  -1  -1  -1  -1  -1  -1
-1 -1  -1  -1  -1  -1  -1  -1  -1  -1  -1  -1  -1  -1  -1  -1
-1 -1  48  49  50  50  51  52  -1  -1  -1  -1  -1  -1  -1  -1
-1 -1  64  65  66  66  67  68  -1  -1  -1  -1  -1  -1  -1  -1
-1 -1  80  81  82  82  83  84  -1  -1  -1  -1  -1  -1  -1  -1
-1 -1  96  97  98  98  98 100  -1  -1  -1  -1  -1  -1  -1  -1
-1 -1 112 113 114 114 114 116  -1  -1  -1  -1  -1  -1  -1  -1
-1 -1  -1  -1  -1  -1  -1  -1  -1  -1  -1  -1  -1  -1  -1  -1
-1 -1  -1  -1  -1  -1  -1  -1  -1  -1  -1  -1  -1  -1  -1  -1
-1 -1  -1  -1  -1  -1  -1  -1  -1  -1  -1  -1  -1  -1  -1  -1
-1 -1  -1  -1  -1  -1  -1  -1  -1  -1  -1  -1  -1  -1  -1  -1
-1 -1  -1  -1  -1  -1  -1  -1  -1  -1  -1  -1  -1  -1  -1  -1
-1 -1  -1  -1  -1  -1  -1  -1  -1  -1  -1  -1  -1  -1  -1  -1
1
-1 -1  -1  -1  -1  -1  -1  -1  -1  -1  -1  -1  -1  -1  -1  -1
-1 -1   0   1   2   2   3   4  -1  -1  -1  -1  -1  -1  -1  -1
-1 -1  16  17  18  18  19  20  -1  -1  -1  -1  -1  -1  -1  -1
-1 -1  32  33  34  34  35  36  -1  -1  -1  -1  -1  -1  -1  -1
-1 -1  -1  -1  -1  -1  -1  -1  -1  -1  -1  -1  -1  -1  -1  -1
-1 -1  -1  -1  -1  -1  -1  -1  -1  -1  -1  -1  -1  -1  -1  -1
-1 -1  -1  -1  -1  -1  -1  -1  -1  -1  -1  -1  -1  -1  -1  -1
-1 -1  -1  -1  -1  -1  -1  -1  -1  -1  -1  -1  -1  -1  -1  -1
-1 -1  -1  -1  -1  -1  -1  -1  -1  -1  -1  -1  -1  -1  -1  -1
-1 -1  -1  -1  -1  -1  -1  -1  -1  -1  -1  -1  -1  -1  -1  -1
-1 -1  -1  -1  -1  -1  -1  -1  -1  -1  -1  -1  -1  -1  -1  -1
-1 -1  -1  -1  -1  -1  -1  -1  -1  -1  -1  -1  -1  -1  -1  -1
-1 -1  -1  -1  -1  -1  -1  -1  -1  -1  -1  -1  -1  -1  -1  -1
-1 -1  -1  -1  -1  -1  -1  -1  -1  -1  -1  -1  -1  -1  -1  -1
-1 -1  -1  -1  -1  -1  -1  -1  -1  -1  -1  -1  -1  -1  -1  -1
0 0 0 0 0 0 0 0 0 0 0 0 0 0 0 0
0 1 1 1 1 1 1 1 1 1 1 1 1 1 1 0
0 1 1 1 1 1 1 1 1 0 1 1 0 1 1 0
0 1 0 0 0 0 0 0 1 1 1 1 1 1 1 0
0 1 0 0 0 0 0 0 1 1 1 1 1 1 1 0
0 1 0 0 0 0 0 0 1 1 1 1 1 1 1 0
0 1 0 0 0 0 0 0 1 1 1 1 1 1 1 0
0 1 0 0 0 0 0 0 1 1 0 1 1 1 1 0
0 1 0 0 0 1 0 0 1 1 1 1 1 1 1 0
0 1 1 1 1 1 1 1 1 1 0 0 0 1 1 0
0 1 1 1 1 1 1 1 1 1 0 0 0 1 1 0
1 1 1 1 1 1 1 1 1 1 1 1 1 1 1 0
1 1 1 1 1 1 1 1 1 1 1 1 1 1 1 0
1 1 1 1 1 1 1 1 1 1 1 1 1 1 1 0
0 0 0 0 0 0 0 0 0 0 0 0 0 0 0 0